1111111111
1P00000001
1000000001
1000000001
10000C0001
1000000001
100A000001
1000000011
1000000E01
1111111111
