111111111111111111111
1PCCCCCCCCCCCCCCCCCE1
111111111111111111111
