1111111111111111111111
1P000000000000000000E1
1000CC00CC000CCCC00001
1000CC00CC00CC00CC0001
1000CCCCCC00000CC00001
10000000CC0000CC000001
10000000CC00CCCCCC0001
1000000000000000000001
1111111111111111111111
