111111111111111111111111111111
10000000P000000000000000C00C11
111C10101010C01010101010101011
1E1010001C1C10CCCCCC0010101E11
1000000000C01010101C1C1010C011
111111111111111111111111111111
